date,transaction_type,description,category,amount_inr,balance_inr
2024-06-11 23:15:00,Debit,Fast Food,Dining,3656.03,46343.97
2024-06-01 14:20:00,Debit,Cafe,Dining,4670.37,41673.6
2024-07-24 08:20:00,Debit,Fuel Station,Transport,229.2,41444.4
2024-07-09 02:46:00,Credit,Credit from Parent,Groceries,4937.65,46382.05
2024-06-05 08:25:00,Debit,Fast Food,Dining,2025.65,44356.4
2024-07-28 05:06:00,Credit,Credit from Refund,Groceries,411.21,44767.61
2024-06-26 19:54:00,Debit,Supermarket,Groceries,376.24,44391.37
2024-07-01 15:31:00,Debit,Supermarket,Groceries,4998.62,39392.75
2024-07-12 20:23:00,Debit,Bus,Transport,3868.04,35524.71
2024-06-12 03:03:00,Debit,Fast Food,Dining,1312.01,34212.7
2024-06-29 12:50:00,Debit,Gift,Miscellaneous,4774.85,29437.85
2024-07-17 16:21:00,Debit,Gift,Miscellaneous,3391.33,26046.52
2024-07-16 00:20:00,Debit,Electronics Store,Shopping,656.43,25390.09
2024-06-01 12:49:00,Debit,Cafe,Dining,3884.36,21505.73
2024-07-12 11:35:00,Debit,Clothing Store,Shopping,2804.34,18701.39
2024-07-14 17:15:00,Credit,Credit from Refund,Miscellaneous,2077.07,20778.459999999995
2024-07-16 02:05:00,Debit,Fuel Station,Transport,3232.87,17545.589999999997
2024-07-18 04:49:00,Debit,Donation,Miscellaneous,1817.88,15727.71
2024-06-04 16:31:00,Debit,Miscellaneous Purchase,Miscellaneous,2243.63,13484.080000000002
2024-07-28 17:04:00,Debit,Clothing Store,Shopping,2618.55,10865.53
2024-07-08 07:07:00,Debit,Online Shopping,Shopping,3148.22,7717.309999999998
2024-07-30 05:45:00,Debit,Fuel Station,Transport,820.66,6896.649999999994
2024-06-20 22:13:00,Debit,Restaurant,Dining,1365.4,5531.249999999993
2024-07-20 22:52:00,Debit,Cafe,Dining,2513.83,3017.419999999991
2024-06-18 19:38:00,Credit,Credit from Parent,Utilities,1276.71,4294.12999999999
2024-07-29 15:58:00,Credit,Credit from Parent,Utilities,3518.57,7812.69999999999
2024-06-13 19:11:00,Debit,Internet Bill,Utilities,2422.41,5390.289999999994
2024-06-02 21:47:00,Credit,Credit from Parent,Dining,1042.22,6432.509999999995
2024-07-12 01:50:00,Credit,Credit from Parent,Dining,967.35,7399.859999999993
2024-07-16 15:25:00,Debit,Fuel Station,Transport,1844.36,5555.499999999993
2024-07-29 18:54:00,Debit,Local Market,Groceries,1717.49,3838.0099999999943
2024-06-25 20:13:00,Debit,Restaurant,Dining,2457.61,1380.3999999999942
2024-07-17 19:55:00,Credit,Credit from Scholarship,Miscellaneous,4612.27,5992.669999999998
2024-07-10 12:06:00,Debit,Clothing Store,Shopping,514.13,5478.540000000001
2024-07-17 09:23:00,Debit,Electronics Store,Shopping,2729.29,2749.25
2024-06-22 21:51:00,Debit,Donation,Miscellaneous,3823.78,-1074.5299999999988
2024-06-08 21:54:00,Credit,Credit from Refund,Dining,405.47,-669.0599999999977
2024-07-18 23:32:00,Debit,Mobile Recharge,Utilities,4237.76,-4906.82
2024-06-03 16:50:00,Debit,Clothing Store,Shopping,4349.35,-9256.169999999998
2024-06-29 21:26:00,Debit,Mobile Recharge,Utilities,613.86,-9870.03
2024-07-26 13:58:00,Debit,Online Shopping,Shopping,2863.43,-12733.46
2024-06-08 09:07:00,Debit,Donation,Miscellaneous,2723.14,-15456.6
2024-06-07 02:32:00,Debit,Ride Share,Transport,2422.45,-17879.050000000003
2024-07-22 08:49:00,Debit,Supermarket,Groceries,2449.95,-20329.0
2024-06-30 20:41:00,Debit,Donation,Miscellaneous,2832.94,-23161.94
2024-07-24 03:52:00,Debit,Electronics Store,Shopping,1955.99,-25117.930000000008
2024-06-17 14:17:00,Debit,Online Shopping,Shopping,3077.02,-28194.95000000001
2024-07-18 07:48:00,Debit,Electricity Bill,Utilities,1718.71,-29913.660000000014
2024-06-17 07:23:00,Debit,Metro,Transport,1204.13,-31117.790000000023
2024-07-04 17:15:00,Debit,Online Shopping,Shopping,1014.18,-32131.970000000016
2024-06-12 21:59:00,Credit,Credit from Parent,Groceries,353.01,-31778.96000000002
2024-07-26 14:37:00,Debit,Electronics Store,Shopping,4493.39,-36272.35000000002
2024-06-25 22:40:00,Debit,Internet Bill,Utilities,125.97,-36398.32000000002
2024-07-17 14:41:00,Debit,Donation,Miscellaneous,3376.35,-39774.67000000003
2024-07-19 05:59:00,Debit,Internet Bill,Utilities,2435.44,-42210.11000000003
2024-06-14 12:17:00,Debit,Metro,Transport,4843.17,-47053.28000000003
2024-07-17 05:17:00,Debit,Clothing Store,Shopping,3707.61,-50760.89000000003
2024-07-24 14:29:00,Credit,Credit from Scholarship,Groceries,3862.12,-46898.77000000003
2024-07-25 19:53:00,Debit,Mobile Recharge,Utilities,2457.59,-49356.36000000003
2024-07-07 19:15:00,Credit,Credit from Refund,Groceries,1749.36,-47607.00000000003
2024-06-29 07:17:00,Debit,Cafe,Dining,1679.53,-49286.53000000003
2024-06-07 17:32:00,Debit,Online Grocery,Groceries,3439.36,-52725.89000000003
2024-07-02 18:38:00,Debit,Mobile Recharge,Utilities,2410.72,-55136.61000000003
2024-07-21 06:49:00,Debit,Miscellaneous Purchase,Miscellaneous,4654.69,-59791.30000000003
2024-07-20 10:51:00,Debit,Online Shopping,Shopping,709.06,-60500.36000000003
2024-07-16 14:57:00,Credit,Credit from Scholarship,Groceries,988.04,-59512.32000000004
2024-06-26 17:45:00,Debit,Clothing Store,Shopping,784.88,-60297.20000000004
2024-06-23 15:26:00,Credit,Credit from Refund,Miscellaneous,4143.15,-56154.05000000005
2024-06-09 00:14:00,Debit,Water Bill,Utilities,2663.02,-58817.07000000005
2024-06-29 01:17:00,Debit,Metro,Transport,2022.98,-60840.05000000005
2024-06-01 16:56:00,Debit,Miscellaneous Purchase,Miscellaneous,3158.1,-63998.15000000005
2024-07-09 14:31:00,Debit,Supermarket,Groceries,1841.28,-65839.43000000005
2024-06-17 03:27:00,Debit,Cafe,Dining,426.43,-66265.86000000004
2024-06-17 21:00:00,Debit,Water Bill,Utilities,4705.18,-70971.04000000004
2024-07-22 10:25:00,Debit,Fast Food,Dining,4405.28,-75376.32000000004
2024-07-28 11:58:00,Debit,Miscellaneous Purchase,Miscellaneous,2908.44,-78284.76000000004
2024-06-07 10:28:00,Debit,Supermarket,Groceries,3564.2,-81848.96000000005
2024-06-09 11:05:00,Debit,Local Market,Groceries,1102.27,-82951.23000000004
2024-07-15 05:44:00,Credit,Credit from Parent,Transport,3797.71,-79153.52000000003
2024-06-28 03:39:00,Debit,Clothing Store,Shopping,724.69,-79878.21000000004
2024-06-06 22:51:00,Debit,Ride Share,Transport,834.6,-80712.81000000004
2024-06-27 10:04:00,Debit,Clothing Store,Shopping,3628.18,-84340.99000000005
2024-07-06 13:34:00,Debit,Internet Bill,Utilities,2759.35,-87100.34000000005
2024-07-13 12:28:00,Debit,Ride Share,Transport,989.83,-88090.17000000004
2024-07-05 00:24:00,Debit,Donation,Miscellaneous,2064.17,-90154.34000000004
2024-06-29 07:34:00,Debit,Miscellaneous Purchase,Miscellaneous,851.42,-91005.76000000008
2024-06-02 18:48:00,Credit,Credit from Refund,Miscellaneous,3096.13,-87909.63000000006
2024-07-14 11:12:00,Debit,Clothing Store,Shopping,4620.25,-92529.88000000006
2024-07-17 22:03:00,Debit,Restaurant,Dining,2923.81,-95453.69000000006
2024-06-02 20:55:00,Debit,Miscellaneous Purchase,Miscellaneous,3708.58,-99162.27000000003
2024-07-04 11:10:00,Credit,Credit from Parent,Miscellaneous,2309.11,-96853.16000000006
2024-06-04 15:38:00,Debit,Cafe,Dining,1012.97,-97866.13000000006
2024-06-28 10:24:00,Debit,Online Grocery,Groceries,1626.08,-99492.21000000004
2024-06-24 00:39:00,Debit,Bus,Transport,368.33,-99860.54000000004
2024-06-10 17:06:00,Debit,Clothing Store,Shopping,122.7,-99983.24000000003
2024-07-13 22:58:00,Debit,Clothing Store,Shopping,4331.24,-104314.48000000004
2024-06-09 19:06:00,Debit,Fast Food,Dining,3713.76,-108028.24000000003
2024-06-27 20:20:00,Credit,Credit from Parent,Utilities,2316.95,-105711.29000000004
2024-06-03 11:21:00,Debit,Online Shopping,Shopping,266.01,-105977.30000000005
2024-06-19 15:34:00,Debit,Bus,Transport,1460.18,-107437.48000000004
2024-07-15 19:05:00,Debit,Restaurant,Dining,2624.35,-110061.83000000005
2024-07-07 06:51:00,Debit,Supermarket,Groceries,2830.8,-112892.63000000003
2024-06-16 17:42:00,Debit,Ride Share,Transport,2560.76,-115453.39000000004
2024-06-06 19:52:00,Debit,Metro,Transport,3774.81,-119228.20000000004
2024-06-22 04:55:00,Credit,Credit from Parent,Utilities,1105.18,-118123.02000000003
2024-07-25 14:03:00,Debit,Metro,Transport,4199.17,-122322.19000000006
2024-07-07 06:56:00,Debit,Local Market,Groceries,3598.89,-125921.08000000007
2024-06-25 11:02:00,Debit,Gift,Miscellaneous,2063.74,-127984.82000000008
2024-07-24 17:33:00,Credit,Credit from Refund,Shopping,1738.38,-126246.44000000006
2024-07-26 06:15:00,Debit,Cafe,Dining,4497.41,-130743.85000000006
2024-07-29 18:51:00,Debit,Online Grocery,Groceries,4896.76,-135640.61000000007
2024-07-14 23:35:00,Debit,Ride Share,Transport,232.77,-135873.38000000006
2024-06-08 14:45:00,Credit,Credit from Refund,Utilities,196.58,-135676.80000000008
2024-06-18 00:58:00,Debit,Bus,Transport,4448.56,-140125.36000000007
2024-07-20 00:32:00,Debit,Fast Food,Dining,1291.54,-141416.90000000008
2024-06-06 15:10:00,Debit,Miscellaneous Purchase,Miscellaneous,4816.98,-146233.8800000001
2024-07-26 01:49:00,Debit,Gift,Miscellaneous,2091.32,-148325.2000000001
2024-06-19 22:26:00,Debit,Fast Food,Dining,3202.88,-151528.0800000001
2024-07-07 19:12:00,Debit,Bus,Transport,701.61,-152229.6900000001
2024-07-28 14:28:00,Debit,Ride Share,Transport,3549.34,-155779.0300000001
2024-06-05 19:10:00,Debit,Ride Share,Transport,1745.74,-157524.77000000008
2024-06-01 03:26:00,Debit,Mobile Recharge,Utilities,267.72,-157792.49000000008
2024-06-17 06:19:00,Debit,Metro,Transport,3891.79,-161684.2800000001
2024-07-06 03:56:00,Debit,Ride Share,Transport,1175.6,-162859.8800000001
2024-07-05 17:35:00,Debit,Clothing Store,Shopping,4355.49,-167215.37000000008
2024-07-08 16:28:00,Debit,Miscellaneous Purchase,Miscellaneous,4019.29,-171234.6600000001
2024-06-13 14:21:00,Debit,Electricity Bill,Utilities,1416.52,-172651.18000000008
2024-07-26 19:16:00,Credit,Credit from Refund,Transport,1363.65,-171287.5300000001
2024-07-20 22:30:00,Credit,Credit from Refund,Miscellaneous,2675.88,-168611.65000000008
2024-07-09 22:04:00,Debit,Bus,Transport,4130.66,-172742.31000000008
2024-07-17 16:14:00,Debit,Restaurant,Dining,1442.87,-174185.18000000008
2024-06-24 11:47:00,Debit,Local Market,Groceries,4165.73,-178350.9100000001
2024-07-09 18:20:00,Debit,Cafe,Dining,770.74,-179121.65000000008
2024-07-14 11:43:00,Debit,Miscellaneous Purchase,Miscellaneous,3027.32,-182148.9700000001
2024-07-27 18:14:00,Debit,Supermarket,Groceries,959.32,-183108.2900000001
2024-07-23 09:30:00,Debit,Restaurant,Dining,1977.38,-185085.6700000001
2024-06-16 11:39:00,Credit,Credit from Refund,Dining,3716.36,-181369.3100000001
2024-07-01 06:25:00,Debit,Restaurant,Dining,2007.55,-183376.8600000001
2024-07-15 11:24:00,Debit,Clothing Store,Shopping,3635.51,-187012.3700000001
2024-06-30 13:17:00,Debit,Donation,Miscellaneous,2043.58,-189055.9500000001
2024-07-05 02:00:00,Debit,Gift,Miscellaneous,2470.4,-191526.3500000001
2024-06-02 20:53:00,Credit,Credit from Scholarship,Shopping,3015.88,-188510.4700000001
2024-07-19 00:43:00,Debit,Electricity Bill,Utilities,857.89,-189368.3600000001
2024-06-19 00:19:00,Debit,Restaurant,Dining,1787.48,-191155.8400000001
2024-07-04 23:25:00,Debit,Supermarket,Groceries,3554.14,-194709.98000000013
2024-06-30 19:41:00,Credit,Credit from Refund,Groceries,472.07,-194237.9100000001
2024-06-16 03:54:00,Debit,Donation,Miscellaneous,2992.13,-197230.04000000007
2024-06-13 12:47:00,Credit,Credit from Scholarship,Shopping,4594.84,-192635.20000000013
2024-06-19 03:05:00,Credit,Credit from Refund,Groceries,2654.37,-189980.83000000013
2024-07-23 14:46:00,Debit,Fuel Station,Transport,3328.04,-193308.8700000001
2024-06-11 21:47:00,Debit,Gift,Miscellaneous,4526.48,-197835.35000000012
2024-06-16 06:16:00,Debit,Water Bill,Utilities,352.82,-198188.17000000016
2024-07-01 17:42:00,Debit,Fast Food,Dining,4996.83,-203185.00000000012
2024-06-17 12:16:00,Credit,Credit from Refund,Miscellaneous,1632.99,-201552.01000000013
2024-06-21 21:20:00,Debit,Online Grocery,Groceries,4629.54,-206181.55000000016
2024-07-17 10:02:00,Credit,Credit from Refund,Transport,3750.82,-202430.73000000016
2024-07-13 14:53:00,Credit,Credit from Refund,Dining,4161.69,-198269.04000000012
2024-06-05 16:56:00,Credit,Credit from Parent,Utilities,690.78,-197578.26000000013
2024-07-09 04:56:00,Debit,Internet Bill,Utilities,2261.06,-199839.32000000012
2024-06-07 13:54:00,Debit,Supermarket,Groceries,3342.11,-203181.4300000001
2024-07-11 07:33:00,Debit,Supermarket,Groceries,3117.73,-206299.16000000012
2024-06-16 05:59:00,Credit,Credit from Parent,Utilities,4952.67,-201346.4900000001
2024-06-04 20:10:00,Debit,Metro,Transport,4701.43,-206047.92000000013
2024-06-03 14:28:00,Debit,Gift,Miscellaneous,3859.22,-209907.14000000013
2024-06-10 09:45:00,Debit,Ride Share,Transport,3174.78,-213081.92000000016
2024-07-16 23:19:00,Debit,Local Market,Groceries,549.33,-213631.25000000015
2024-06-25 03:26:00,Credit,Credit from Parent,Shopping,3688.13,-209943.12000000017
2024-07-22 01:30:00,Debit,Donation,Miscellaneous,4278.83,-214221.9500000002
2024-07-13 10:07:00,Debit,Fuel Station,Transport,1458.6,-215680.55000000016
2024-07-18 19:20:00,Debit,Online Grocery,Groceries,1983.2,-217663.75000000015
2024-07-08 18:24:00,Debit,Electronics Store,Shopping,4754.81,-222418.56000000017
2024-07-06 10:05:00,Debit,Internet Bill,Utilities,2146.15,-224564.7100000002
2024-07-03 08:16:00,Debit,Miscellaneous Purchase,Miscellaneous,4528.25,-229092.9600000002
2024-06-28 07:53:00,Debit,Electronics Store,Shopping,2067.74,-231160.7000000002
2024-07-14 01:23:00,Credit,Credit from Refund,Miscellaneous,4170.15,-226990.55000000016
2024-07-28 18:51:00,Credit,Credit from Refund,Dining,1180.38,-225810.17000000016
2024-07-07 14:53:00,Debit,Gift,Miscellaneous,383.43,-226193.60000000012
2024-07-16 08:38:00,Debit,Supermarket,Groceries,4645.99,-230839.5900000001
2024-06-17 10:24:00,Debit,Bus,Transport,2041.59,-232881.18000000017
2024-07-17 15:32:00,Debit,Gift,Miscellaneous,854.09,-233735.2700000002
2024-07-30 10:56:00,Debit,Gift,Miscellaneous,1196.71,-234931.9800000002
2024-06-19 13:36:00,Debit,Local Market,Groceries,4314.62,-239246.6000000002
2024-06-01 14:14:00,Debit,Mobile Recharge,Utilities,734.62,-239981.2200000002
2024-06-27 19:43:00,Debit,Local Market,Groceries,4324.43,-244305.6500000002
2024-06-06 03:12:00,Debit,Supermarket,Groceries,3702.54,-248008.19000000015
2024-07-09 16:00:00,Debit,Electronics Store,Shopping,124.9,-248133.0900000002
2024-07-03 10:37:00,Debit,Cafe,Dining,497.13,-248630.2200000002
2024-07-06 07:39:00,Debit,Ride Share,Transport,473.04,-249103.26000000015
2024-06-19 06:29:00,Debit,Ride Share,Transport,2628.79,-251732.05000000016
2024-07-15 06:14:00,Debit,Internet Bill,Utilities,3344.35,-255076.4000000001
2024-07-19 22:27:00,Debit,Fuel Station,Transport,3696.16,-258772.5600000001
2024-07-07 13:42:00,Credit,Credit from Parent,Shopping,870.97,-257901.5900000001
2024-06-09 19:28:00,Debit,Electricity Bill,Utilities,3517.61,-261419.20000000013
2024-06-18 14:22:00,Debit,Water Bill,Utilities,1027.19,-262446.39000000013
2024-06-26 19:17:00,Debit,Metro,Transport,2380.8,-264827.1900000001
2024-07-18 03:03:00,Debit,Cafe,Dining,4117.74,-268944.9300000001
2024-07-07 04:03:00,Debit,Cafe,Dining,4177.46,-273122.39000000013
2024-07-16 15:33:00,Debit,Restaurant,Dining,3122.94,-276245.33000000013
2024-06-25 02:18:00,Credit,Credit from Parent,Groceries,1945.81,-274299.52000000014
2024-07-26 23:43:00,Debit,Internet Bill,Utilities,624.21,-274923.73000000016
2024-06-16 17:51:00,Debit,Restaurant,Dining,4818.66,-279742.39000000013
2024-06-18 11:44:00,Credit,Credit from Scholarship,Shopping,4666.94,-275075.4500000001
2024-06-30 05:47:00,Debit,Electronics Store,Shopping,915.25,-275990.7000000001
2024-07-30 20:42:00,Credit,Credit from Refund,Groceries,2420.51,-273570.1900000001
2024-07-06 21:03:00,Debit,Cafe,Dining,4951.73,-278521.9200000001
2024-06-11 21:48:00,Debit,Electronics Store,Shopping,737.42,-279259.3400000001
2024-07-05 14:11:00,Debit,Bus,Transport,4125.41,-283384.75000000006
2024-06-02 22:51:00,Debit,Mobile Recharge,Utilities,3448.15,-286832.9000000001
2024-07-10 01:30:00,Debit,Donation,Miscellaneous,4985.91,-291818.81000000006
2024-07-21 01:22:00,Debit,Fuel Station,Transport,901.76,-292720.57000000007
2024-06-25 03:14:00,Credit,Credit from Scholarship,Transport,1181.77,-291538.80000000005
2024-06-08 22:11:00,Debit,Online Shopping,Shopping,743.54,-292282.34
2024-06-03 00:31:00,Debit,Gift,Miscellaneous,4723.72,-297006.06
2024-07-17 17:10:00,Debit,Internet Bill,Utilities,2048.21,-299054.27
2024-07-29 04:03:00,Debit,Mobile Recharge,Utilities,2105.74,-301160.01
2024-06-07 00:40:00,Debit,Restaurant,Dining,1081.76,-302241.77
2024-07-29 22:56:00,Debit,Online Shopping,Shopping,4335.36,-306577.13
2024-07-29 05:59:00,Credit,Credit from Refund,Shopping,1098.14,-305478.99
2024-07-20 12:15:00,Credit,Credit from Parent,Utilities,2698.74,-302780.25
2024-06-08 17:11:00,Debit,Clothing Store,Shopping,4568.0,-307348.25
2024-06-27 01:04:00,Credit,Credit from Refund,Shopping,2364.28,-304983.97
2024-06-02 06:02:00,Debit,Local Market,Groceries,3459.27,-308443.24
2024-06-06 15:55:00,Debit,Gift,Miscellaneous,888.04,-309331.28
2024-07-22 03:36:00,Debit,Fuel Station,Transport,2992.29,-312323.56999999995
2024-06-28 08:24:00,Credit,Credit from Scholarship,Transport,156.94,-312166.62999999995
2024-07-03 19:34:00,Debit,Miscellaneous Purchase,Miscellaneous,3040.1,-315206.7299999999
2024-06-16 05:18:00,Debit,Fuel Station,Transport,4314.6,-319521.3299999999
2024-07-30 17:01:00,Credit,Credit from Parent,Utilities,3770.89,-315750.4399999999
2024-07-13 03:53:00,Debit,Miscellaneous Purchase,Miscellaneous,2544.55,-318294.9899999999
2024-06-22 01:06:00,Credit,Credit from Parent,Shopping,2842.28,-315452.70999999985
2024-06-12 13:26:00,Debit,Restaurant,Dining,530.55,-315983.25999999983
2024-07-03 12:43:00,Debit,Supermarket,Groceries,485.03,-316468.28999999986
2024-06-12 08:51:00,Debit,Cafe,Dining,2880.95,-319349.2399999999
2024-07-24 17:31:00,Credit,Credit from Parent,Dining,1080.74,-318268.4999999999
2024-06-02 10:09:00,Credit,Credit from Scholarship,Utilities,3561.73,-314706.7699999999
2024-06-22 22:56:00,Debit,Online Grocery,Groceries,3103.43,-317810.1999999999
2024-06-15 12:52:00,Debit,Online Shopping,Shopping,3163.99,-320974.1899999999
2024-06-21 17:35:00,Debit,Mobile Recharge,Utilities,492.56,-321466.7499999999
2024-07-13 15:54:00,Debit,Online Shopping,Shopping,4104.76,-325571.5099999999
2024-07-21 11:34:00,Debit,Mobile Recharge,Utilities,2679.37,-328250.8799999999
2024-06-30 20:56:00,Debit,Water Bill,Utilities,395.73,-328646.60999999987
2024-06-06 03:20:00,Debit,Fuel Station,Transport,4371.74,-333018.34999999986
2024-06-30 14:42:00,Debit,Gift,Miscellaneous,992.38,-334010.72999999986
2024-06-11 12:31:00,Debit,Internet Bill,Utilities,2821.28,-336832.0099999999
2024-07-06 16:47:00,Debit,Gift,Miscellaneous,4982.04,-341814.0499999999
2024-07-17 07:30:00,Debit,Internet Bill,Utilities,1077.76,-342891.8099999999
2024-06-04 02:59:00,Debit,Metro,Transport,250.2,-343142.0099999999
2024-06-05 08:55:00,Debit,Clothing Store,Shopping,4354.54,-347496.5499999999
2024-07-12 00:00:00,Debit,Ride Share,Transport,2184.92,-349681.46999999986
2024-06-09 11:03:00,Credit,Credit from Parent,Shopping,4939.48,-344741.9899999999
2024-06-21 08:19:00,Credit,Credit from Scholarship,Utilities,2981.49,-341760.4999999999
2024-06-09 22:34:00,Debit,Online Shopping,Shopping,3028.85,-344789.34999999986
2024-06-23 17:11:00,Debit,Fast Food,Dining,3002.52,-347791.8699999999
2024-06-04 20:19:00,Debit,Electronics Store,Shopping,3152.54,-350944.40999999986
2024-07-08 01:11:00,Debit,Online Grocery,Groceries,3902.4,-354846.8099999999
2024-07-13 13:07:00,Debit,Miscellaneous Purchase,Miscellaneous,3199.45,-358046.2599999999
2024-07-04 13:54:00,Credit,Credit from Parent,Dining,2123.85,-355922.4099999999
2024-06-02 18:37:00,Debit,Donation,Miscellaneous,4366.67,-360289.0799999999
2024-06-27 15:20:00,Debit,Local Market,Groceries,566.78,-360855.8599999999
2024-07-27 22:58:00,Debit,Supermarket,Groceries,2055.33,-362911.19
2024-06-02 12:40:00,Debit,Bus,Transport,2983.22,-365894.4099999999
2024-07-18 13:37:00,Debit,Clothing Store,Shopping,1261.44,-367155.8499999999
2024-07-03 14:55:00,Debit,Fast Food,Dining,2265.92,-369421.7699999999
2024-06-15 19:57:00,Credit,Credit from Parent,Transport,3380.01,-366041.7599999999
2024-07-24 19:45:00,Debit,Electronics Store,Shopping,4748.06,-370789.8199999999
2024-06-02 23:49:00,Debit,Gift,Miscellaneous,3067.14,-373856.9599999999
2024-07-13 10:55:00,Debit,Clothing Store,Shopping,3930.77,-377787.7299999999
2024-07-05 19:08:00,Debit,Electronics Store,Shopping,4354.53,-382142.26
2024-06-27 17:07:00,Credit,Credit from Refund,Transport,1421.77,-380720.48999999993
2024-06-17 04:48:00,Debit,Ride Share,Transport,353.31,-381073.79999999993
2024-06-03 18:27:00,Credit,Credit from Parent,Utilities,982.05,-380091.75
2024-07-11 21:11:00,Credit,Credit from Parent,Groceries,303.71,-379788.0399999999
2024-06-16 13:19:00,Debit,Fast Food,Dining,124.21,-379912.25
2024-07-03 02:14:00,Debit,Restaurant,Dining,4352.8,-384265.04999999993
2024-07-19 19:11:00,Debit,Water Bill,Utilities,1779.0,-386044.04999999993
2024-07-01 14:24:00,Debit,Gift,Miscellaneous,803.36,-386847.4099999999
2024-07-19 16:11:00,Credit,Credit from Refund,Shopping,895.67,-385951.73999999993
2024-06-29 08:18:00,Debit,Ride Share,Transport,1249.35,-387201.0899999999
2024-07-02 14:45:00,Debit,Restaurant,Dining,4206.76,-391407.8499999999
2024-06-14 18:30:00,Debit,Cafe,Dining,2536.16,-393944.0099999999
2024-06-13 02:29:00,Debit,Online Grocery,Groceries,4661.65,-398605.6599999999
2024-06-05 18:53:00,Debit,Supermarket,Groceries,1156.81,-399762.4699999999
2024-07-26 11:49:00,Credit,Credit from Scholarship,Transport,3291.04,-396471.42999999993
2024-07-03 20:53:00,Debit,Cafe,Dining,1658.75,-398130.17999999993
2024-06-03 09:16:00,Debit,Supermarket,Groceries,3933.69,-402063.87
2024-07-22 14:10:00,Debit,Online Grocery,Groceries,4404.73,-406468.5999999999
2024-07-23 22:13:00,Debit,Donation,Miscellaneous,2247.04,-408715.6399999999
2024-06-05 02:15:00,Debit,Fuel Station,Transport,1654.26,-410369.8999999999
2024-06-14 16:58:00,Credit,Credit from Refund,Groceries,2768.0,-407601.8999999999
2024-06-22 08:26:00,Debit,Local Market,Groceries,2041.25,-409643.1499999999
2024-07-05 06:57:00,Debit,Clothing Store,Shopping,2298.6,-411941.7499999999
2024-07-04 14:44:00,Credit,Credit from Refund,Groceries,1213.62,-410728.1299999999
2024-07-08 12:45:00,Debit,Donation,Miscellaneous,3135.5,-413863.6299999999
2024-06-28 15:10:00,Debit,Electricity Bill,Utilities,4330.33,-418193.9599999999
2024-06-04 21:20:00,Credit,Credit from Parent,Miscellaneous,4087.45,-414106.5099999999
2024-06-29 07:24:00,Debit,Restaurant,Dining,1305.74,-415412.2499999999
2024-07-22 18:23:00,Debit,Internet Bill,Utilities,2792.13,-418204.3799999999
2024-07-02 17:54:00,Debit,Electronics Store,Shopping,2654.05,-420858.4299999999
2024-07-10 11:15:00,Credit,Credit from Refund,Utilities,4493.9,-416364.5299999999
2024-07-22 05:04:00,Credit,Credit from Parent,Groceries,1962.37,-414402.1599999999
2024-07-10 05:31:00,Debit,Miscellaneous Purchase,Miscellaneous,596.96,-414999.1199999999
2024-06-13 21:49:00,Debit,Ride Share,Transport,3383.47,-418382.5899999999
2024-07-01 04:44:00,Credit,Credit from Scholarship,Shopping,2946.57,-415436.01999999984
2024-07-28 15:09:00,Debit,Cafe,Dining,1435.86,-416871.87999999983
2024-06-26 03:32:00,Debit,Local Market,Groceries,987.63,-417859.50999999983
2024-07-01 05:25:00,Debit,Fast Food,Dining,2673.3,-420532.8099999998
2024-07-03 18:42:00,Debit,Local Market,Groceries,1007.62,-421540.4299999998
2024-06-23 15:55:00,Debit,Online Shopping,Shopping,4049.36,-425589.7899999998
2024-07-14 21:28:00,Credit,Credit from Scholarship,Transport,650.29,-424939.4999999998
2024-06-24 11:48:00,Debit,Gift,Miscellaneous,4432.61,-429372.1099999998
2024-06-13 23:51:00,Debit,Online Grocery,Groceries,3093.81,-432465.9199999998
2024-06-03 09:00:00,Debit,Metro,Transport,4510.11,-436976.0299999998
2024-06-01 05:01:00,Debit,Fast Food,Dining,3924.58,-440900.6099999998
2024-07-02 09:56:00,Debit,Internet Bill,Utilities,2176.32,-443076.9299999998
2024-07-16 23:55:00,Debit,Fast Food,Dining,3156.91,-446233.8399999998
2024-07-08 16:00:00,Debit,Restaurant,Dining,923.27,-447157.1099999998
2024-07-16 15:26:00,Credit,Credit from Parent,Dining,1162.03,-445995.0799999998
2024-06-08 06:52:00,Debit,Internet Bill,Utilities,1110.31,-447105.3899999998
2024-06-05 05:42:00,Credit,Credit from Parent,Groceries,3196.88,-443908.5099999998
2024-07-05 22:56:00,Debit,Fast Food,Dining,3025.53,-446934.0399999998
2024-07-30 05:54:00,Debit,Cafe,Dining,2284.38,-449218.4199999998
2024-06-19 12:01:00,Debit,Mobile Recharge,Utilities,1771.34,-450989.75999999983
2024-06-25 00:24:00,Debit,Online Shopping,Shopping,1752.41,-452742.1699999998
2024-06-23 17:45:00,Debit,Metro,Transport,1397.99,-454140.1599999998
2024-06-17 00:53:00,Debit,Electronics Store,Shopping,2065.82,-456205.9799999998
2024-07-16 21:45:00,Debit,Gift,Miscellaneous,3124.06,-459330.0399999998
2024-07-07 00:45:00,Credit,Credit from Parent,Shopping,3381.05,-455948.9899999998
2024-06-26 10:31:00,Debit,Donation,Miscellaneous,3432.65,-459381.63999999984
2024-07-21 16:31:00,Credit,Credit from Scholarship,Dining,1032.59,-458349.0499999998
2024-06-03 18:54:00,Debit,Gift,Miscellaneous,4977.85,-463326.8999999998
2024-06-08 16:53:00,Debit,Online Shopping,Shopping,2855.25,-466182.1499999998
2024-06-13 13:10:00,Debit,Fuel Station,Transport,3481.02,-469663.1699999998
2024-06-25 20:17:00,Debit,Cafe,Dining,2171.18,-471834.3499999998
2024-07-10 13:18:00,Debit,Clothing Store,Shopping,1574.18,-473408.5299999998
2024-07-27 23:54:00,Credit,Credit from Refund,Utilities,1974.38,-471434.1499999998
2024-06-08 10:49:00,Debit,Gift,Miscellaneous,3712.18,-475146.32999999984
2024-07-02 06:17:00,Credit,Credit from Scholarship,Groceries,3390.64,-471755.6899999998
2024-07-17 01:20:00,Debit,Fast Food,Dining,4336.96,-476092.6499999998
2024-06-20 06:31:00,Credit,Credit from Parent,Shopping,880.59,-475212.0599999998
2024-07-25 05:09:00,Credit,Credit from Refund,Dining,1864.67,-473347.38999999984
2024-07-09 00:28:00,Debit,Supermarket,Groceries,2597.65,-475945.0399999998
2024-06-05 00:41:00,Debit,Miscellaneous Purchase,Miscellaneous,4717.7,-480662.73999999976
2024-06-14 07:50:00,Debit,Miscellaneous Purchase,Miscellaneous,3952.75,-484615.48999999976
2024-07-05 12:09:00,Debit,Clothing Store,Shopping,2016.11,-486631.5999999997
2024-07-06 09:53:00,Debit,Local Market,Groceries,2744.69,-489376.2899999997
2024-06-21 13:12:00,Debit,Donation,Miscellaneous,4353.48,-493729.76999999967
2024-06-08 09:27:00,Debit,Online Shopping,Shopping,496.5,-494226.26999999967
2024-06-07 01:16:00,Debit,Fast Food,Dining,3505.26,-497731.5299999997
2024-07-19 19:56:00,Debit,Online Shopping,Shopping,3240.76,-500972.2899999997
2024-06-02 15:28:00,Debit,Supermarket,Groceries,4323.87,-505296.1599999997
2024-07-24 20:55:00,Debit,Gift,Miscellaneous,3070.64,-508366.7999999997
2024-06-05 14:55:00,Debit,Ride Share,Transport,2562.57,-510929.3699999997
2024-07-19 15:11:00,Credit,Credit from Scholarship,Groceries,1900.92,-509028.4499999996
2024-07-24 01:49:00,Credit,Credit from Parent,Shopping,1239.5,-507788.9499999996
2024-07-09 17:26:00,Debit,Donation,Miscellaneous,1460.99,-509249.9399999996
2024-06-10 07:23:00,Debit,Bus,Transport,3135.98,-512385.9199999996
2024-06-23 06:57:00,Debit,Mobile Recharge,Utilities,400.61,-512786.5299999996
2024-07-25 14:57:00,Debit,Restaurant,Dining,385.0,-513171.5299999996
2024-06-08 14:46:00,Debit,Bus,Transport,3505.67,-516677.1999999996
2024-07-07 18:01:00,Credit,Credit from Scholarship,Utilities,797.02,-515880.1799999996
2024-07-05 12:46:00,Debit,Miscellaneous Purchase,Miscellaneous,971.06,-516851.2399999997
2024-07-05 22:20:00,Debit,Online Grocery,Groceries,1221.58,-518072.8199999996
2024-06-16 17:57:00,Debit,Clothing Store,Shopping,3157.09,-521229.9099999996
2024-07-09 14:49:00,Debit,Fast Food,Dining,3981.26,-525211.1699999996
2024-07-10 08:21:00,Debit,Bus,Transport,1902.02,-527113.1899999996
2024-06-22 13:04:00,Debit,Miscellaneous Purchase,Miscellaneous,3694.71,-530807.8999999996
2024-07-19 19:53:00,Debit,Miscellaneous Purchase,Miscellaneous,2139.15,-532947.0499999996
2024-07-07 19:26:00,Debit,Donation,Miscellaneous,1373.08,-534320.1299999995
2024-06-11 15:38:00,Debit,Fast Food,Dining,3132.85,-537452.9799999995
2024-07-18 05:47:00,Credit,Credit from Parent,Dining,3183.56,-534269.4199999995
2024-07-26 15:35:00,Credit,Credit from Refund,Transport,2490.48,-531778.9399999995
2024-06-14 13:08:00,Credit,Credit from Scholarship,Transport,1403.49,-530375.4499999995
2024-06-03 02:51:00,Debit,Online Shopping,Shopping,1690.91,-532066.3599999995
2024-07-04 20:27:00,Debit,Electricity Bill,Utilities,3109.0,-535175.3599999995
2024-07-08 12:21:00,Credit,Credit from Parent,Dining,4785.49,-530389.8699999995
2024-07-17 02:52:00,Debit,Supermarket,Groceries,3471.86,-533861.7299999995
2024-07-11 12:15:00,Credit,Credit from Parent,Transport,4220.27,-529641.4599999995
2024-07-10 00:19:00,Debit,Electronics Store,Shopping,2527.72,-532169.1799999995
2024-06-23 06:53:00,Credit,Credit from Parent,Miscellaneous,3108.27,-529060.9099999995
2024-07-19 09:18:00,Debit,Electricity Bill,Utilities,3713.43,-532774.3399999995
2024-07-27 01:38:00,Credit,Credit from Refund,Transport,304.2,-532470.1399999995
2024-06-28 14:14:00,Credit,Credit from Parent,Groceries,4030.44,-528439.6999999996
2024-07-21 10:15:00,Debit,Ride Share,Transport,3713.79,-532153.4899999996
2024-07-22 01:23:00,Debit,Miscellaneous Purchase,Miscellaneous,4856.67,-537010.1599999997
2024-06-12 19:39:00,Debit,Internet Bill,Utilities,1838.72,-538848.8799999997
2024-07-29 01:33:00,Credit,Credit from Scholarship,Transport,4169.62,-534679.2599999997
2024-07-22 06:47:00,Debit,Miscellaneous Purchase,Miscellaneous,502.64,-535181.8999999997
2024-07-28 11:10:00,Debit,Supermarket,Groceries,1971.5,-537153.3999999997
2024-07-26 07:14:00,Credit,Credit from Parent,Groceries,1377.5,-535775.8999999997
2024-06-20 14:51:00,Debit,Fast Food,Dining,305.56,-536081.4599999997
2024-06-19 00:25:00,Debit,Ride Share,Transport,1534.83,-537616.2899999997
2024-06-23 08:57:00,Debit,Gift,Miscellaneous,2953.87,-540570.1599999997
2024-06-06 18:28:00,Debit,Online Shopping,Shopping,727.67,-541297.8299999997
2024-06-05 03:09:00,Debit,Fast Food,Dining,565.56,-541863.3899999998
2024-07-07 02:30:00,Debit,Donation,Miscellaneous,3103.4,-544966.7899999998
2024-06-01 19:10:00,Debit,Gift,Miscellaneous,3412.31,-548379.0999999999
2024-07-22 21:40:00,Debit,Supermarket,Groceries,1500.94,-549880.0399999998
2024-07-17 06:17:00,Debit,Supermarket,Groceries,2765.68,-552645.7199999999
2024-06-12 17:36:00,Debit,Gift,Miscellaneous,4894.15,-557539.8699999999
2024-07-03 01:35:00,Credit,Credit from Scholarship,Miscellaneous,984.91,-556554.9599999998
2024-06-06 10:05:00,Debit,Miscellaneous Purchase,Miscellaneous,1419.72,-557974.6799999998
2024-06-04 15:17:00,Debit,Metro,Transport,628.92,-558603.5999999999
2024-06-14 22:16:00,Debit,Electronics Store,Shopping,4829.14,-563432.7399999999
2024-07-02 15:03:00,Debit,Clothing Store,Shopping,2125.74,-565558.4799999999
2024-07-10 06:36:00,Debit,Online Grocery,Groceries,1557.99,-567116.4699999999
2024-06-03 07:43:00,Debit,Metro,Transport,4379.28,-571495.7499999999
2024-06-10 09:00:00,Debit,Bus,Transport,888.16,-572383.9099999999
2024-07-07 23:02:00,Debit,Supermarket,Groceries,4419.11,-576803.0199999999
2024-06-21 09:35:00,Debit,Internet Bill,Utilities,4411.1,-581214.1199999999
2024-06-07 17:02:00,Debit,Local Market,Groceries,3737.51,-584951.6299999999
2024-06-12 18:44:00,Debit,Mobile Recharge,Utilities,3470.63,-588422.2599999999
2024-07-12 09:58:00,Debit,Local Market,Groceries,4255.43,-592677.69
2024-07-22 03:46:00,Debit,Clothing Store,Shopping,154.05,-592831.74
2024-07-30 01:47:00,Debit,Fuel Station,Transport,3424.06,-596255.8
2024-07-17 16:15:00,Debit,Miscellaneous Purchase,Miscellaneous,4982.04,-601237.8400000001
2024-07-18 22:42:00,Debit,Ride Share,Transport,3638.15,-604875.9900000001
2024-06-10 05:24:00,Debit,Water Bill,Utilities,2018.48,-606894.4700000001
2024-07-21 13:09:00,Debit,Metro,Transport,3135.99,-610030.4600000001
2024-07-29 19:04:00,Debit,Supermarket,Groceries,555.65,-610586.1100000001
2024-07-13 15:09:00,Credit,Credit from Scholarship,Shopping,3247.4,-607338.7100000001
2024-06-07 13:15:00,Debit,Online Shopping,Shopping,2484.33,-609823.04
2024-07-08 17:40:00,Debit,Mobile Recharge,Utilities,212.37,-610035.41
2024-07-01 14:38:00,Debit,Miscellaneous Purchase,Miscellaneous,386.9,-610422.31
2024-07-25 17:52:00,Debit,Donation,Miscellaneous,3567.64,-613989.9500000001
2024-07-06 14:53:00,Credit,Credit from Parent,Utilities,1929.97,-612059.9800000001
2024-07-25 17:01:00,Credit,Credit from Refund,Groceries,1919.97,-610140.0100000001
2024-07-12 22:43:00,Debit,Electricity Bill,Utilities,4672.26,-614812.2700000001
2024-06-21 05:24:00,Debit,Local Market,Groceries,3217.27,-618029.5400000002
2024-07-01 11:59:00,Debit,Mobile Recharge,Utilities,2108.53,-620138.0700000002
2024-06-25 11:27:00,Debit,Mobile Recharge,Utilities,2902.17,-623040.2400000002
2024-07-14 13:52:00,Credit,Credit from Refund,Groceries,4900.27,-618139.9700000002
2024-07-10 06:53:00,Debit,Local Market,Groceries,4175.32,-622315.2900000002
2024-07-12 01:01:00,Debit,Online Grocery,Groceries,1563.76,-623879.0500000002
2024-06-19 12:06:00,Debit,Fast Food,Dining,2205.32,-626084.3700000001
2024-06-17 00:09:00,Debit,Ride Share,Transport,1011.9,-627096.2700000001
2024-07-26 06:45:00,Debit,Restaurant,Dining,3559.49,-630655.7600000001
2024-07-18 11:45:00,Debit,Miscellaneous Purchase,Miscellaneous,4529.18,-635184.9400000002
2024-06-28 21:18:00,Debit,Local Market,Groceries,380.67,-635565.6100000002
2024-07-16 10:17:00,Debit,Clothing Store,Shopping,3781.74,-639347.3500000002
2024-06-17 04:09:00,Credit,Credit from Scholarship,Shopping,437.89,-638909.4600000002
2024-06-07 19:43:00,Debit,Miscellaneous Purchase,Miscellaneous,1310.2,-640219.6600000001
2024-07-12 18:40:00,Debit,Cafe,Dining,2201.55,-642421.2100000002
2024-06-30 03:35:00,Credit,Credit from Scholarship,Miscellaneous,2489.1,-639932.1100000002
2024-06-07 15:00:00,Debit,Fast Food,Dining,782.3,-640714.4100000003
2024-06-12 08:44:00,Debit,Online Grocery,Groceries,1801.98,-642516.3900000002
2024-06-04 04:51:00,Debit,Fast Food,Dining,4820.63,-647337.0200000003
2024-06-20 05:03:00,Debit,Metro,Transport,4156.56,-651493.5800000003
2024-07-07 02:31:00,Debit,Gift,Miscellaneous,2522.96,-654016.5400000003
2024-07-11 01:19:00,Credit,Credit from Parent,Transport,3653.26,-650363.2800000003
2024-06-22 12:17:00,Debit,Mobile Recharge,Utilities,4862.83,-655226.1100000002
2024-07-05 02:35:00,Credit,Credit from Refund,Groceries,659.07,-654567.0400000003
2024-07-13 06:50:00,Debit,Restaurant,Dining,4268.02,-658835.0600000003
2024-07-17 02:27:00,Debit,Supermarket,Groceries,1214.31,-660049.3700000003
2024-06-13 13:11:00,Debit,Electricity Bill,Utilities,3979.33,-664028.7000000003
2024-07-12 03:55:00,Debit,Cafe,Dining,1208.12,-665236.8200000003
2024-07-21 06:09:00,Debit,Restaurant,Dining,790.7,-666027.5200000003
2024-06-09 06:58:00,Debit,Local Market,Groceries,578.06,-666605.5800000003
2024-06-25 10:35:00,Debit,Electricity Bill,Utilities,3771.49,-670377.0700000003
2024-06-03 18:40:00,Credit,Credit from Refund,Miscellaneous,2350.28,-668026.7900000003
2024-07-20 00:28:00,Debit,Online Grocery,Groceries,4373.46,-672400.2500000002
2024-06-27 14:24:00,Credit,Credit from Parent,Shopping,3795.13,-668605.1200000002
2024-07-19 05:29:00,Debit,Donation,Miscellaneous,1270.1,-669875.2200000002
2024-07-28 15:06:00,Debit,Cafe,Dining,2834.11,-672709.3300000002
2024-06-15 10:04:00,Debit,Miscellaneous Purchase,Miscellaneous,4555.18,-677264.5100000002
2024-07-30 17:47:00,Debit,Electronics Store,Shopping,616.82,-677881.3300000002
2024-06-27 17:34:00,Debit,Online Grocery,Groceries,1964.06,-679845.3900000002
2024-06-03 08:13:00,Debit,Mobile Recharge,Utilities,1098.46,-680943.8500000002
2024-06-09 10:41:00,Debit,Clothing Store,Shopping,2930.21,-683874.0600000002
2024-06-19 23:50:00,Debit,Online Grocery,Groceries,1059.62,-684933.6800000002
2024-06-18 14:31:00,Debit,Cafe,Dining,2293.25,-687226.9300000002
2024-06-11 15:05:00,Debit,Fast Food,Dining,3106.02,-690332.9500000002
2024-07-23 07:53:00,Debit,Water Bill,Utilities,927.39,-691260.3400000002
2024-07-24 07:57:00,Debit,Clothing Store,Shopping,263.58,-691523.9200000002
2024-07-16 19:13:00,Debit,Electronics Store,Shopping,1634.49,-693158.4100000001
2024-07-10 21:38:00,Credit,Credit from Refund,Miscellaneous,4298.68,-688859.7300000001
2024-06-15 03:18:00,Debit,Miscellaneous Purchase,Miscellaneous,4838.92,-693698.6500000001
2024-06-03 06:27:00,Debit,Fuel Station,Transport,3653.41,-697352.0600000002
2024-07-28 11:05:00,Debit,Online Shopping,Shopping,4900.93,-702252.9900000002
2024-06-27 17:53:00,Debit,Electricity Bill,Utilities,2842.8,-705095.7900000003
2024-06-19 02:52:00,Debit,Local Market,Groceries,1127.79,-706223.5800000003
2024-06-08 20:58:00,Debit,Electricity Bill,Utilities,1750.52,-707974.1000000003
2024-06-01 06:52:00,Debit,Donation,Miscellaneous,642.67,-708616.7700000004
2024-06-06 05:43:00,Debit,Online Grocery,Groceries,4516.35,-713133.1200000003
2024-06-24 06:16:00,Debit,Supermarket,Groceries,1346.18,-714479.3000000004
2024-07-13 03:32:00,Debit,Online Shopping,Shopping,951.43,-715430.7300000004
2024-07-01 20:25:00,Debit,Cafe,Dining,3623.48,-719054.2100000004
2024-06-27 21:56:00,Credit,Credit from Refund,Dining,3724.39,-715329.8200000004
2024-06-14 02:48:00,Debit,Online Grocery,Groceries,3142.55,-718472.3700000005
2024-06-25 19:35:00,Debit,Ride Share,Transport,2409.31,-720881.6800000005
2024-07-03 20:15:00,Debit,Electricity Bill,Utilities,718.7,-721600.3800000005
2024-07-28 16:02:00,Credit,Credit from Refund,Dining,3463.0,-718137.3800000005
2024-07-30 17:19:00,Debit,Gift,Miscellaneous,3310.88,-721448.2600000005
2024-06-13 11:15:00,Debit,Internet Bill,Utilities,4345.29,-725793.5500000005
2024-06-27 06:41:00,Debit,Bus,Transport,3839.46,-729633.0100000005
2024-07-20 01:20:00,Debit,Online Shopping,Shopping,4527.68,-734160.6900000005
2024-07-16 11:50:00,Debit,Online Grocery,Groceries,389.56,-734550.2500000006
2024-06-25 05:51:00,Credit,Credit from Refund,Utilities,4383.71,-730166.5400000006
2024-07-11 23:51:00,Debit,Water Bill,Utilities,2290.57,-732457.1100000006
2024-06-06 02:37:00,Debit,Clothing Store,Shopping,2778.58,-735235.6900000005
2024-06-23 13:19:00,Debit,Miscellaneous Purchase,Miscellaneous,642.53,-735878.2200000006
2024-07-13 16:36:00,Debit,Local Market,Groceries,4598.58,-740476.8000000005
2024-07-02 02:51:00,Debit,Online Grocery,Groceries,4866.6,-745343.4000000005
2024-06-26 03:28:00,Debit,Electricity Bill,Utilities,4213.36,-749556.7600000005
2024-06-14 23:50:00,Debit,Miscellaneous Purchase,Miscellaneous,2840.01,-752396.7700000005
2024-07-20 10:20:00,Credit,Credit from Scholarship,Groceries,4376.49,-748020.2800000005
2024-07-01 01:26:00,Debit,Fuel Station,Transport,434.87,-748455.1500000005
2024-07-18 12:50:00,Debit,Supermarket,Groceries,2396.96,-750852.1100000005
2024-06-15 19:52:00,Debit,Electricity Bill,Utilities,1556.47,-752408.5800000004
2024-07-09 05:49:00,Debit,Gift,Miscellaneous,335.9,-752744.4800000004
2024-06-10 23:57:00,Debit,Restaurant,Dining,1719.0,-754463.4800000004
2024-06-29 20:35:00,Credit,Credit from Refund,Transport,3993.43,-750470.0500000004
2024-07-03 14:39:00,Debit,Internet Bill,Utilities,3966.89,-754436.9400000004
2024-06-01 12:08:00,Debit,Fuel Station,Transport,1336.31,-755773.2500000005
2024-07-06 01:57:00,Debit,Clothing Store,Shopping,3714.07,-759487.3200000004
2024-07-16 23:54:00,Debit,Online Grocery,Groceries,4163.51,-763650.8300000004
2024-06-28 17:54:00,Credit,Credit from Scholarship,Groceries,3502.81,-760148.0200000004
2024-07-03 20:00:00,Debit,Online Shopping,Shopping,3892.01,-764040.0300000004
2024-07-26 04:19:00,Debit,Restaurant,Dining,935.85,-764975.8800000004
2024-06-12 15:39:00,Debit,Gift,Miscellaneous,3542.91,-768518.7900000004
2024-07-15 09:32:00,Debit,Online Shopping,Shopping,3955.08,-772473.8700000003
2024-07-21 15:36:00,Debit,Online Shopping,Shopping,1430.69,-773904.5600000003
2024-06-17 23:46:00,Debit,Supermarket,Groceries,1417.9,-775322.4600000003
2024-06-26 15:39:00,Credit,Credit from Scholarship,Miscellaneous,114.31,-775208.1500000003
2024-07-19 12:56:00,Debit,Fast Food,Dining,786.12,-775994.2700000003
2024-06-25 11:50:00,Debit,Supermarket,Groceries,1723.6,-777717.8700000002
2024-07-12 02:03:00,Debit,Miscellaneous Purchase,Miscellaneous,2292.59,-780010.4600000002
2024-07-28 09:17:00,Debit,Supermarket,Groceries,2731.34,-782741.8000000002
2024-07-07 01:34:00,Debit,Local Market,Groceries,4183.25,-786925.0500000002
2024-07-16 01:35:00,Debit,Local Market,Groceries,2367.97,-789293.0200000001
2024-06-23 10:27:00,Debit,Donation,Miscellaneous,1538.1,-790831.1200000001
2024-07-08 13:38:00,Debit,Supermarket,Groceries,1494.36,-792325.4800000001
2024-07-13 07:21:00,Debit,Bus,Transport,4411.33,-796736.81
2024-06-04 19:26:00,Debit,Ride Share,Transport,3541.07,-800277.88
2024-06-06 18:55:00,Debit,Bus,Transport,1446.18,-801724.06
2024-06-08 17:30:00,Debit,Electronics Store,Shopping,2114.0,-803838.06
2024-07-13 01:26:00,Debit,Fuel Station,Transport,3078.74,-806916.8
2024-07-17 07:43:00,Debit,Metro,Transport,4779.8,-811696.6000000001
2024-06-19 21:12:00,Debit,Online Grocery,Groceries,110.31,-811806.9100000001
2024-06-01 17:42:00,Debit,Online Grocery,Groceries,4370.83,-816177.7400000001
2024-07-29 09:16:00,Debit,Online Shopping,Shopping,4021.74,-820199.4800000001
2024-06-15 23:05:00,Debit,Bus,Transport,3021.98,-823221.4600000001
2024-06-16 01:29:00,Debit,Supermarket,Groceries,2080.77,-825302.2300000001
2024-06-08 18:14:00,Debit,Online Grocery,Groceries,2122.11,-827424.3400000001
2024-06-07 11:48:00,Debit,Cafe,Dining,4451.39,-831875.7300000001
2024-06-17 11:14:00,Credit,Credit from Refund,Miscellaneous,780.47,-831095.2600000001
2024-06-27 11:02:00,Credit,Credit from Scholarship,Shopping,3647.47,-827447.7900000002
2024-07-22 17:00:00,Debit,Metro,Transport,4162.19,-831609.9800000001
2024-06-05 17:21:00,Debit,Restaurant,Dining,3504.92,-835114.9000000001
2024-07-21 04:27:00,Debit,Electricity Bill,Utilities,513.52,-835628.4200000002
2024-07-04 10:16:00,Debit,Fuel Station,Transport,4059.31,-839687.7300000002
2024-06-17 09:45:00,Credit,Credit from Parent,Groceries,4101.94,-835585.7900000003
2024-07-28 13:13:00,Debit,Miscellaneous Purchase,Miscellaneous,2206.66,-837792.4500000003
2024-07-21 09:52:00,Debit,Supermarket,Groceries,4322.54,-842114.9900000003
2024-07-24 12:12:00,Debit,Online Shopping,Shopping,1982.77,-844097.7600000004
2024-07-01 17:41:00,Credit,Credit from Refund,Shopping,3820.82,-840276.9400000004
2024-06-02 01:42:00,Debit,Fast Food,Dining,3045.26,-843322.2000000004
2024-06-16 01:17:00,Credit,Credit from Refund,Groceries,2607.24,-840714.9600000004
2024-07-03 10:52:00,Debit,Clothing Store,Shopping,4461.48,-845176.4400000004
2024-07-05 23:03:00,Debit,Electronics Store,Shopping,224.69,-845401.1300000004
2024-06-28 03:21:00,Credit,Credit from Scholarship,Shopping,1768.96,-843632.1700000004
2024-07-14 15:36:00,Debit,Electricity Bill,Utilities,596.17,-844228.3400000004
2024-06-14 05:45:00,Debit,Cafe,Dining,2324.61,-846552.9500000004
2024-07-28 23:00:00,Credit,Credit from Refund,Transport,2479.39,-844073.5600000004
2024-07-08 23:33:00,Credit,Credit from Scholarship,Utilities,765.37,-843308.1900000004
2024-06-19 17:22:00,Credit,Credit from Scholarship,Miscellaneous,2001.14,-841307.0500000004
2024-06-20 15:35:00,Debit,Miscellaneous Purchase,Miscellaneous,820.6,-842127.6500000004
2024-06-10 14:07:00,Debit,Restaurant,Dining,4193.85,-846321.5000000003
2024-06-30 09:48:00,Debit,Clothing Store,Shopping,2422.63,-848744.1300000004
2024-06-19 08:32:00,Debit,Restaurant,Dining,4921.66,-853665.7900000004
2024-07-28 20:05:00,Debit,Gift,Miscellaneous,1989.01,-855654.8000000004
2024-07-11 04:14:00,Debit,Clothing Store,Shopping,855.31,-856510.1100000005
2024-06-28 23:02:00,Debit,Restaurant,Dining,3833.32,-860343.4300000004
2024-06-26 18:00:00,Debit,Mobile Recharge,Utilities,1581.43,-861924.8600000005
2024-06-01 22:04:00,Debit,Water Bill,Utilities,382.47,-862307.3300000004
2024-06-25 22:29:00,Debit,Clothing Store,Shopping,4835.45,-867142.7800000004
2024-06-14 19:10:00,Credit,Credit from Refund,Utilities,2944.29,-864198.4900000003
2024-06-25 00:18:00,Debit,Bus,Transport,4102.11,-868300.6000000003
2024-07-21 02:04:00,Debit,Fuel Station,Transport,3699.43,-872000.0300000004
2024-06-19 14:30:00,Debit,Gift,Miscellaneous,3983.35,-875983.3800000004
2024-06-18 13:29:00,Debit,Ride Share,Transport,293.35,-876276.7300000003
2024-07-09 06:49:00,Debit,Online Shopping,Shopping,1215.97,-877492.7000000003
2024-06-11 18:05:00,Debit,Metro,Transport,3638.5,-881131.2000000003
2024-07-01 21:22:00,Debit,Online Shopping,Shopping,740.2,-881871.4000000003
2024-07-30 20:28:00,Debit,Clothing Store,Shopping,3991.63,-885863.0300000003
2024-06-04 07:08:00,Credit,Credit from Refund,Miscellaneous,4725.81,-881137.2200000002
2024-06-07 13:15:00,Debit,Cafe,Dining,2984.78,-884122.0000000002
2024-06-03 13:49:00,Debit,Miscellaneous Purchase,Miscellaneous,1095.79,-885217.7900000003
2024-06-22 01:55:00,Debit,Mobile Recharge,Utilities,4601.8,-889819.5900000003
2024-07-09 17:31:00,Debit,Online Grocery,Groceries,4482.82,-894302.4100000003
2024-07-11 03:19:00,Debit,Electronics Store,Shopping,3050.37,-897352.7800000003
2024-06-10 02:36:00,Credit,Credit from Parent,Transport,1082.33,-896270.4500000003
2024-06-18 16:30:00,Debit,Supermarket,Groceries,4250.15,-900520.6000000003
2024-06-30 09:44:00,Debit,Mobile Recharge,Utilities,4428.98,-904949.5800000004
2024-06-30 19:18:00,Debit,Bus,Transport,3170.3,-908119.8800000004
2024-07-07 06:24:00,Debit,Cafe,Dining,3469.84,-911589.7200000004
2024-06-28 06:58:00,Debit,Donation,Miscellaneous,758.73,-912348.4500000004
2024-07-26 16:59:00,Debit,Online Shopping,Shopping,1733.7,-914082.1500000004
2024-07-13 19:09:00,Debit,Gift,Miscellaneous,3987.63,-918069.7800000004
2024-07-16 20:40:00,Debit,Cafe,Dining,4159.5,-922229.2800000004
2024-06-20 10:56:00,Debit,Electricity Bill,Utilities,1774.73,-924004.0100000002
2024-06-17 15:20:00,Debit,Fuel Station,Transport,3791.8,-927795.8100000004
2024-06-24 07:51:00,Debit,Online Grocery,Groceries,4433.68,-932229.4900000005
2024-07-28 12:48:00,Debit,Local Market,Groceries,480.48,-932709.9700000004
2024-07-17 23:21:00,Debit,Miscellaneous Purchase,Miscellaneous,423.45,-933133.4200000004
2024-06-26 06:35:00,Debit,Water Bill,Utilities,4060.35,-937193.7700000004
2024-06-16 18:20:00,Debit,Restaurant,Dining,4780.06,-941973.8300000004
2024-06-25 01:00:00,Debit,Restaurant,Dining,2553.06,-944526.8900000004
2024-06-15 06:39:00,Debit,Donation,Miscellaneous,457.22,-944984.1100000005
2024-07-13 19:22:00,Debit,Online Shopping,Shopping,1476.92,-946461.0300000004
2024-07-24 03:39:00,Credit,Credit from Refund,Miscellaneous,1404.22,-945056.8100000004
2024-06-16 02:12:00,Debit,Bus,Transport,1207.54,-946264.3500000004
2024-06-22 01:54:00,Debit,Fuel Station,Transport,3057.12,-949321.4700000004
2024-06-10 14:43:00,Debit,Supermarket,Groceries,702.31,-950023.7800000004
2024-07-20 19:26:00,Debit,Donation,Miscellaneous,2970.74,-952994.5200000004
2024-06-13 06:00:00,Debit,Online Shopping,Shopping,1285.47,-954279.9900000005
2024-07-07 11:28:00,Debit,Clothing Store,Shopping,4039.4,-958319.3900000004
2024-06-27 16:13:00,Debit,Clothing Store,Shopping,4592.28,-962911.6700000004
2024-07-07 13:18:00,Debit,Electronics Store,Shopping,877.26,-963788.9300000004
2024-07-07 14:56:00,Debit,Fast Food,Dining,366.23,-964155.1600000004
2024-07-18 19:46:00,Debit,Online Grocery,Groceries,1026.29,-965181.4500000004
2024-06-14 06:07:00,Credit,Credit from Scholarship,Dining,3564.18,-961617.2700000004
2024-06-29 18:30:00,Debit,Local Market,Groceries,1309.44,-962926.7100000004
2024-06-18 00:24:00,Debit,Ride Share,Transport,599.27,-963525.9800000004
2024-06-05 22:34:00,Debit,Electricity Bill,Utilities,4229.29,-967755.2700000004
2024-07-25 18:19:00,Debit,Online Shopping,Shopping,4470.17,-972225.4400000004
2024-06-08 14:55:00,Debit,Local Market,Groceries,1948.86,-974174.3000000004
2024-06-08 15:43:00,Debit,Fuel Station,Transport,3466.39,-977640.6900000004
2024-06-15 21:27:00,Debit,Online Grocery,Groceries,4236.82,-981877.5100000004
2024-06-17 15:19:00,Credit,Credit from Refund,Transport,4390.01,-977487.5000000003
2024-07-16 23:23:00,Debit,Online Grocery,Groceries,4725.51,-982213.0100000004
2024-06-21 15:03:00,Debit,Electronics Store,Shopping,3208.26,-985421.2700000004
2024-06-07 11:37:00,Debit,Supermarket,Groceries,2543.0,-987964.2700000004
2024-07-03 05:47:00,Debit,Online Grocery,Groceries,2342.73,-990307.0000000003
2024-07-13 17:29:00,Credit,Credit from Parent,Miscellaneous,1912.08,-988394.9200000004
2024-07-29 19:05:00,Debit,Metro,Transport,2805.14,-991200.0600000004
2024-06-23 04:01:00,Debit,Restaurant,Dining,3321.03,-994521.0900000004
2024-06-24 03:07:00,Debit,Gift,Miscellaneous,4001.58,-998522.6700000004
2024-06-19 23:55:00,Debit,Metro,Transport,2034.2,-1000556.8700000006
2024-06-04 08:35:00,Debit,Online Shopping,Shopping,3711.77,-1004268.6400000006
2024-06-14 23:59:00,Debit,Clothing Store,Shopping,3442.75,-1007711.3900000006
2024-07-04 01:25:00,Debit,Supermarket,Groceries,1508.31,-1009219.7000000008
2024-06-27 10:48:00,Debit,Supermarket,Groceries,646.41,-1009866.1100000006
2024-07-25 16:32:00,Credit,Credit from Parent,Shopping,4193.85,-1005672.2600000004
2024-07-09 09:24:00,Credit,Credit from Scholarship,Miscellaneous,194.71,-1005477.5500000004
2024-07-10 14:43:00,Debit,Electricity Bill,Utilities,3707.38,-1009184.9300000004
2024-06-25 16:27:00,Debit,Online Shopping,Shopping,1406.71,-1010591.6400000004
2024-07-28 12:44:00,Debit,Local Market,Groceries,2643.26,-1013234.9000000004
2024-06-20 02:52:00,Debit,Electronics Store,Shopping,3892.56,-1017127.4600000004
2024-06-24 20:29:00,Debit,Online Shopping,Shopping,4299.93,-1021427.3900000004
2024-07-02 13:25:00,Debit,Fast Food,Dining,1974.64,-1023402.0300000004
